#COMMENT: PvZ 2 Codenames List! Last Update: 8/12/2018.

Zombies:

Ancient Egypt:

Mummy Zombie - mummy
Conehead Mummy - mummy_armor1
Buckethead Mummy - mummy_armor2
Pyramid-Head Zombie - mummy_armor4
Egypt Flag Zombie - mummy_flag
Egypt Rally Zombie - mummy_flag_veteran
Ra Zombie - ra
Camel Zombies (Segment) - camel_segment
Camel Zombies (3 parts) - camel_onehump
Camel Zombies (4 parts) - camel_twohump
Camel Zombies (6 parts) - camel_manyhump
Mummy Memory Camels (Segment) - camel_segment_touch
Mummy Memory Camels (3 parts) - camel_onehump_touch
Mummy Memory Camels (4 parts) - camel_twohump_touch
Mummy Memory Camels (6 parts) - camel_manyhump_touch
Explorer Zombie - explorer
Torchlight Zombie - explorer_veteran
Tomb Raiser Zombie - tomb_raiser
Pharaoh Zombie - pharaoh
Imp Mummy - egypt_imp
Mummified Gargantuar - egypt_gargantuar

Pirate Seas:

Pirate Zombie - pirate
Conehead Pirate - pirate_armor1
Buckethead Pirate - pirate_armor2
Barrelhead Zombie - pirate_armor4
Flag Pirate Zombie - pirate_flag
Jolly Roger Zombie - pirate_flag_veteran
Swashbuckler Zombie - swashbuckler
Seagull Zombie - seagull
Pelican Zombie - pelican
Barrel Roller Zombie - barrelroller
Imp Pirate Zombie - pirate_imp
Imp Cannon - cannon
Pirate Captain Zombie - pirate_captain
Parrot Zombie - pirate_captain_parrot
Gargantuar Pirate - pirate_gargantuar

Wild West:

Cowboy Zombie - cowboy
Conehead Cowboy - cowboy_armor1
Buckethead Cowboy - cowboy_armor2
Cart-Head Zombie - cowboy_armor4
Flag Cowboy Zombie - cowboy_flag
Cowboy Rally Zombie - cowboy_flag_veteran
Prospector Zombie - prospector
Pianist Zombie - piano
Poncho Zombie - poncho
Poncho Zombie (No plate) - poncho_no_plate
Poncho Zombie (Always has plate) - poncho_plate
Chicken Wrangler Zombie - chicken_farmer
Chicken - chicken
Zombie Bull - west_bull
Rodeo Legend Zombie - west_bull_veteran
Zombie Bull Rider - west_bullrider
Cowboy Gargantuar - cowboy_gargantuar

Far Future:

Future Zombie - future
Future Conehead - future_armor1
Future Buckethead - future_armor2
Holo-Head Zombie - future_armor4
Future Flag Zombie - future_flag
Robo-Rally Zombie - future_flag_veteran
Jetpack Zombie - future_jetpack
Disco Jetpack Zombie - future_jetpack_disco
Blastronaut Zombie - future_jetpack_veteran
Shield Zombie - future_protector
Robo-Cone Zombie - mech_cone
Bug-Bot Imp - future_imp
Disco-tron 3000 - disco_mech
Mecha-Football Zombie - football_mech
Gargantuar Prime - future_gargantuar

Dark Ages:

Peasant Zombie - dark
Conehead Peasant - dark_armor1
Buckethead Peasant - dark_armor2
Knight Zombie - dark_armor3
Peasant Flag Zombie - dark_flag
Imp Monk Zombie - dark_imp
Jester Zombie - dark_juggler
Wizard Zombie - dark_wizard
Zombie King - dark_king
Imp Dragon Zombie - dark_imp_dragon
Dark Ages Gargantuar - dark_gargantuar

Big Wave Beach:

Pompadour Zombie - beach
Pompadour Conehead - beach_armor1
Pompadour Buckethead - beach_armor2
Bikini Zombie - beach_fem
Bikini Conehead - beach_fem_armor1
Bikini Buckethead - beach_fem_armor2
Beach Flag Zombie - beach_flag
Snorkel Zombie - beach_snorkel
Surfer Zombie - beach_surfer
Imp Mermaid Zombie - beach_imp
Octo Zombie - beach_octopus
Fisherman Zombie - beach_fisherman
Deep Sea Gargantuar - beach_gargantuar

Frostbite Caves:

Cave Zombie - iceage
Cave Conehead - iceage_armor1
Cave Buckethead - iceage_armor2
Blockhead Zombie - iceage_armor3
Cave Flag Zombie - iceage_flag
Hunter Zombie - iceage_hunter
Dodo Rider Zombie - iceage_dodo
Yeti Imp - iceage_imp
Troglobite (3 blocks) - iceage_troglobite
Troglobite (2 blocks) - iceage_troglobite_2block
Troglobite (1 block) - iceage_troglobite_1block
Weasel Hoarder - iceage_weaselhoarder
Ice Weasel - iceage_weasel
Sloth Gargantuar - iceage_gargantuar

Lost City:

Adventurer Zombie - lostcity
Conehead Adventurer - lostcity_armor1
Buckethead Adventurer - lostcity_armor2
Flag Adventurer - lostcity_flag
Excavator Zombie - lostcity_excavator
Parasol Zombie - lostcity_jane
Lost Pilot Zombie - lostcity_lostpilot
Lost City Imp - lostcity_imp
Bug Zombie - lostcity_bug
Bug Zombie (Conehead) - lostcity_bug_armor1
Bug Zombie (Buckethead) - lostcity_bug_armor2
Imp Porter - lostcity_impporter
Relic Hunter Zombie - lostcity_relichunter
Turquoise Skull Zombie - lostcity_crystalskull
Porter Gargantuar - lostcity_gargantuar

Neon Mixtape Tour:

Neon Zombie - eighties
Neon Conehead - eighties_armor1
Neon Buckethead - eighties_armor2
Neon Flag Zombie - eighties_flag
Punk Zombie - eighties_punk
Glitter Zombie - eighties_glitter
MC Zom-B - eighties_mc
Impunk - eighties_imp
Breakdancer Zombie - eighties_breakdancer
Arcade Zombie - eighties_arcade
8-Bit Zombie - eighties_8bit
8-Bit Zombie (Conehead) - eighties_8bit_armor1
8-Bit Zombie (Buckethead) - eighties_8bit_armor2
Boombox Zombie - eighties_boombox
Hair Metal Gargantuar - eighties_gargantuar

Jurassic Marsh:

Jurassic Zombie - dino
Jurassic Conehead - dino_armor1
Jurassic Buckethead - dino_armor2
Jurassic Fossilhead - dino_armor3
Amberhead Zombie - dino_armor4
Jurassic Flag Zombie - dino_flag
Jurassic Rally Zombie - dino_flag_veteran
Jurassic Imp - dino_imp
Jurassic Bully - dino_bully
Jurassic Rockpuncher - dino_bully_veteran
Jurassic Gargantuar - dino_gargantuar

Modern Day:

Basic Zombie - tutorial
Conehead Zombie - tutorial_armor1
Buckethead Zombie - tutorial_armor2
Brickhead Zombie - tutorial_armor4
Flag Zombie - tutorial_flag
Rally Zombie - tutorial_flag_veteran
Imp - tutorial_imp
Gargantuar - tutorial_gargantuar
Newspaper Zombie - modern_newspaper
Sunday Edition Zombie - newspaper_veteran
Balloon Zombie - modern_balloon
All-Star Zombie - modern_allstar
Super-Fan Imp - modern_superfanimp

Battlez:

Hamster Ball - hamster_ball

Special Zombies:

Treasure Yeti - treasureyeti
Vase Gargantuar - vase_gargantuar

Valenbrainz:

Valenbrainz Basic - valentines
Valenbrainz Conehead - valentines_armor1
Valenbrainz Buckethead - valentines_armor2
Valenbrainz Flag - valentines_flag
Valenbrainz Imp - valentines_imp
Valenbrainz Gargantuar - valentines_gargantuar

Luck 'O the Zombie:

Paddy's Zombie - stpatrick
Paddy's Conehead - stpatrick_armor1
Paddy's Buckethead - stpatrick_armor2
Leprechaun Imp - leprachaun_imp
Leprechaun Dodo Rider - leprachaun_dodo

The Springening:

Springening Zombie - spring
Springening Conehead - spring_armor1
Springening Buckethead - spring_armor2
Springening Flag Zombie - spring_flag
Springening Imp - spring_imp
Springening Imp (April Fools) - spring_imp_af
Springening Camels (Segment) - spring_camel_segment
Springening Camels (3 parts) - spring_camel_onehump
Springening Camels (4 parts) - spring_camel_twohump
Springening Camels (6 parts) - spring_camel_manyhump
Springening Poncho Zombie - spring_poncho
Springening Wizard Zombie - spring_wizard
Springening Troglobite (3 blocks) - easter_troglobite
Springening Troglobite (2 blocks) - easter_troglobite_2block
Springening Troglobite (1 block) - easter_troglobite_1block
Springening Gargantuar - spring_gargantuar
Springening Gargantuar (April Fools) - spring_gargantuar_af

Birthdayz:

Birthdayz Zombie - birthday
Birthdayz Flag Zombie - birthday_flag
Birthdayz Pharaoh - birthday_pharaoh
Birthdayz Barrel - birthday_barrel
Birthdayz Jetpack - birthday_jetpack
Birthdayz Jester - birthday_juggler
Birthdayz Troglobite (3 blocks)  - birthday_troglobite
Birthdayz Troglobite (2 blocks) - birthday_troglobite_2block
Birthdayz Troglobite (1 block) - birthday_troglobite_1block
Birthdayz Gargantuar - birthday_gargantuar

Summer Nights:

Summer Zombie - summer_basic
Summer Conehead - summer_armor1
Summer Buckethead - summer_armor2
Summer Flag Zombie - summer_flag
Summer Bug - summer_bug
Summer Bug (Conehead) - summer_bug_armor1
Summer Bug (Buckethead) - summer_bug_armor2
Hot Dog Imp - summer_imp
King of the Grill (Gargantuar) - summer_gargantuar

Big Brainz:

Big Brainz Basic - bighead
Big Brainz Conehead - bighead_armor1
Big Brainz Buckethead - bighead_armor2
Big Brainz Flag Zombie - bighead_flag
Big Brainz Imp - bighead_imp
Big Brainz Gargantuar - bighead_gargantuar
Big Brainz Newspaper - bighead_newspaper
Big Brainz Balloon - bighead_balloon
Big Brainz All-Star - bighead_allstar
Big Brainz Super-Fan Imp - bighead_superfan
Big Brainz Barrel Roller - bighead_barrelroller
Big Brainz Barrel - bighead_barrel

Lawn of Doom:

Spooky Scary Zombie - halloween
Spooky Scary Conehead - halloween_armor1
Spooky Scary Buckethead - halloween_armor2
Scarecrow Flag Zombie - halloween_flag
Bride Imp - halloween_imp
Frankentuar - halloween_gargantuar

Plants vs. Zombies Heroes Event:

Electric Boogaloo - hero_electricboogaloo
Impfinity - hero_impfinity
Rustbolt - hero_rustbolt
Super Brainz - hero_superbrainz
Heroic Barrel Roller - hero_barrelroller
Heroic Barrel - hero_barrel
The Smash - hero_smash

Food Fight:

Food-Fighter Zombie - foodfight
Food-Fighter Conehead - foodfight_armor1
Food-Fighter Buckethead - foodfight_armor2
Food-Fighter Flag - foodfight_flag
Chefster - foodfight_chefster
Turkey Wrangler - foodfight_gobbler_king
Turkey - foodfight_turkey

Feastivus:

Feastivus Zombie - feastivus
Feastivus Conehead - feastivus_armor1
Feastivus Buckethead - feastivus_armor2
Feastivus Flag Zombie - feastivus_flag
Feastivus Imp - feastivus_imp
Other Feastivus Imp - holiday_imp
Feastivus Pianist - feastivus_piano
Feastivus Swashbuckler - feastivus_swashbuckler
Feastivus Poncho - feastivus_poncho
Feastivus Camels (Segment) - feastivus_camel_segment
Feastivus Camels (3 parts) - feastivus_camel_onehump
Feastivus Camels (4 parts) - feastivus_camel_twohump
Feastivus Camels (6 parts) - feastivus_camel_manyhump
Feastivus Troglobite (3 blocks) - feastivus_troglobite
Feastivus Troglobite (2 blocks) - feastivus_troglobite_2block
Feastivus Troglobite (1 block) - feastivus_troglobite_1block
Feastivus Gargantuar - feastivus_gargantuar
Other Feastivus Gargantuar - holiday_gargantuar

Beghouled Zombies:

Basic Zombie - beghouled
Conehead Zombie - beghouled_armor1
Buckethead Zombie - beghouled_armor2
Newspaper Zombie - beghouled_newspaper
Mummy Zombie - beghouled_mummy
Conehead Mummy - beghouled_mummy_armor1
Buckethead Mummy - beghouled_mummy_armor2
Pirate Zombie - beghouled_pirate
Conehead Pirate - beghouled_pirate_armor1
Buckethead Pirate - beghouled_pirate_armor2
Cowboy Zombie - beghouled_cowboy
Conehead Cowboy - beghouled_cowboy_armor1
Buckethead Cowboy - beghouled_cowboy_armor2
Future Zombie - beghouled_future
Future Conehead - beghouled_future_armor1
Future Buckethead - beghouled_future_armor2
Peasant Zombie - beghouled_dark
Conehead Peasant - beghouled_dark_armor1
Buckethead Peasant - beghouled_dark_armor2
Pompadour Zombie - beghouled_beach
Pompadour Conehead - beghouled_beach_armor1
Pompadour Buckethead - beghouled_beach_armor2
Bikini Zombie - beghouled_beach_fem
Bikini Conehead - beghouled_beach_fem_armor1
Bikini Buckethead - beghouled_beach_fem_armor2
Cave Zombie - beghouled_iceage
Cave Conehead - beghouled_iceage_armor1
Cave Buckethead - beghouled_iceage_armor2
Adventurer Zombie - beghouled_lostcity
Conehead Adventurer - beghouled_lostcity_armor1
Buckethead Adventurer - beghouled_lostcity_armor2

Zomboss Mechs:

Zombot Sphinx-inator - zombossmech_egypt
Zombot Sphinx-inator 2.0 - zombossmech_egypt2
Zombot Sphinx-inator (Modern) - zombossmech_modern_egypt
Zombot Plank Walker - zombossmech_pirate
Zombot Plank Walker 2.0 - zombossmech_pirate2
Zombot Plank Walker (Modern) - zombossmech_modern_pirate
Zombot War Wagon - zombossmech_cowboy
Zombot War Wagon 2.0 - zombossmech_cowboy2
Zombot War Wagon (Modern) - zombossmech_modern_cowboy
Zombot Tomorrow-tron - zombossmech_future
Zombot Tomorrow-tron 2.0 - zombossmech_future2
Zombot Tomorrow-tron (Modern) - zombossmech_modern_future
Zombot Dark Dragon - zombossmech_dark
Zombot Dark Dragon (Modern) - zombossmech_modern_dark
Zombot Sharktronic Sub - zombossmech_beach
Zombot Sharktronic Sub (Modern) - zombossmech_modern_beach
Zombot Tuskmaster 10,000 BC - zombossmech_iceage
Zombot Tuskmaster 10,000 BC (Modern) - zombossmech_modern_iceage
Zombot Aerostatic Gondola - zombossmech_lostcity
Zombot Aerostatic Gondola (Modern) - zombossmech_modern_lostcity
Zombot Multi-stage Masher - zombossmech_eighties
Zombot Multi-stage Masher (Modern) - zombossmech_modern_eighties
Zombot Dinotronic Mechasaur - zombossmech_dino
Zombot Dinotronic Mechasaur 2.0 - zombossmech_dino2
Zombot Dinotronic Mechasaur (Modern) - zombossmech_modern_dino
Zombot Tomorrow-tron (Modern Day - Day 44) - zombossmech_modern1

Unused/Upcoming Zombies:

Cleopatra - cleopatra
Pet Zombie - pet
Fastswimmer - beach_fastswimmer
Halloween Camel (4 parts) - halloween_camel_twohump
Shield Zombie (Unused Veteran) - future_protector_veteran
Robo-Cone Zombie (Unused Veteran) - mech_cone_veteran
??? - dark_armor4
??? - dark_flag_veteran
??? - dark_wizard_veteran


Plants:

Ancient Egypt:

Cabbage-pult - cabbagepult
Bloomerang - bloomerang
Iceburg Lettuce - iceburg
Grave Buster - gravebuster
Bonk Choy - bonkchoy
Repeater - repeater
Twin Sunflower - twinsunflower

Pirate Seas:

Kernel-pult - kernelpult
Snapdragon - snapdragon
Spikeweed - spikeweed
Coconut Cannon - coconutcannon
Spring Bean - springbean
Threepeater - threepeater
Spikerock - spikerock
Cherry Bomb - cherry_bomb

Wild West:

Split Pea - splitpea
Chili Bean - chilibean
Lightning Reed - lightningreed
Tall-nut - tallnut
Pea Pod - peapod
Melon-pult - melonpult
Winter Melon - wintermelon

Far Future:

Laser Bean - laser_bean
Blover - blover
Citron - citron
E.M. Peach - empea
Infi-nut - holonut
Magnifying Grass - magnifyinggrass
Tile Turnip - powerplant

Dark Ages:

Sun-shroom - sunshroom
Puff-shroom - puffshroom
Fume-shroom - fumeshroom
Sun Bean - sunbean
Magnet-shroom - magnetshroom

Big Wave Beach:

Lily Pad - lilypad
Tangle Kelp - tanglekelp
Bowling Bulb - bowlingbulb
Guacodile - guacodile
Banana Launcher - banana

Frostbite Caves: 

Hot Potato - hotpotato
Pepper-pult - pepperpult
Chard Guard - chardguard
Stunion - stunion
Rotobaga - xshot

Lost City:

Red Stinger - redstinger
A.K.E.E. - akee
Endurian - endurian
Stallia - stallia
Gold Leaf - goldleaf

Neon Mixtape Tour:

Phat Beet - phatbeet
Celery Stalker - celerystalker
Thyme Warp - thymewarp
Garlic - garlic
Spore-shroom - sporeshroom
Intensive Carrot - intensivecarrot

Jurassic Marsh:

Primal Peashooter - primalpeashooter
Primal Wall-nut - primalwallnut
Perfume-shroom - perfumeshroom
Primal Sunflower - primalsunflower
Primal Potato Mine - primalpotatomine

Modern Day/Tutorial:

Peashooter - peashooter
Sunflower - sunflower
Wall-nut - wallnut
Potato Mine - potatomine
Moonflower - moonflower
Nightshade - nightshade
Shadow-shroom - shadowshroom
Dusk Lobber - dusklobber
Grimrose - grimrose

Premium Plants Set 1:

Snow Pea - snowpea
Power Lily - powerlily
Squash - squash
Torchwood - torchwood
Jalapeno - jalapeno
Imitater - imitater
Starfruit - starfruit
Hypno-shroom - hypnoshroom
Pea-nut - peanut
Chomper - chomper
Homing Thistle - homingthistle
Ghost Pepper - ghostpepper
Sweet Potato - sweetpotato
Sap-fling - sapfling

Premium Plants Set 2:

Hurrikale - hurrikale
Fire Peashooter - firepeashooter
Dandelion - dandelion
Lava Guava - lavaguava
Toadstool - toadstool
Strawburst - strawburst
Cactus - cactus
Electric Blueberry - electricblueberry
Jack O' Lantern - jackolantern
Grapeshot - grapeshot
Cold Snapdragon - coldsnapdragon

Premium Plants Set 3:

Shrinking Violet - shrinkingviolet
Blooming Heart - bloominghearts
Escape Root - escaperoot
Wasabi Whip - wasabiwhip
Explode-O-nut - explodeonut
Kiwibeast - kiwibeast
Apple Mortar - applemortar
Bombegranate - bombegranate
Witch Hazel - witchhazel
Parsnip - parsnip
Missile Toe - missiletoe

Premium Plants Set 4:

Hot Date - hotdate
Caulipower - caulipower
Electric Peashooter - electricpeashooter
Gold Bloom - goldbloom
Aloe - aloe
Electric Currant - electriccurrant
Solar Tomato - solartomato
Holly Barrier - hollyknight

Power Mints:

Fila-mint - filamint
Reinforce-mint - reinforcemint
Bombard-mint - bombardmint
Arma-mint - armamint
Contain-mint - containmint
Enchant-mint - enchantmint
Spear-mint - spearmint
Pepper-mint - peppermint
Winter-mint - wintermint
Conceal-mint - concealmint
Enforce-mint - enforcemint
Enlighten-mint - enlightenmint
Ail-mint - ailmint
Appease-mint - appeasemint

Premium Plants Set 5:

#COMMENT: This list is incomplete. It will be updated as soon as new updates come out.

Shadow Peashooter - shadowpeashooter
Poison Peashooter - poisonpeashooter
Arma-mint Peashooter - armamintpeashooter

Tool Packets:

Power Tile (Alpha) - tool_powertile_alpha
Power Tile (Beta) - tool_powertile_beta
Power Tile (Gamma) - tool_powertile_gamma
Power Tile (Delta) - tool_powertile_delta
Power Tile (Epsilon) - tool_powertile_epsilon
Small Bulb - tool_projectile_bowlingbulb1
Medium Bulb - tool_projectile_bowlingbulb2
Large Bulb - tool_projectile_bowlingbulb3
Exploding Bulb - tool_projectile_bowlingbulb_explode
Gigantic Bulb - tool_projectile_bowlingbulb_mega

Other/Unused:

Marigold - marigold
Holly Barrier Leaf - hollybarrierleaf
Holly Barrier Leaf (Plant Food) - hollybarrierleafplantfood
Sun Gun - sungun
Sun Pod - sunpod
Sprout - sprout

Jurassic Marsh Dinos:

Raptor - raptor
Stegosaurus - stego
Pterodactyl - ptero
Rex - tyranno
Ankylosaurus - ankylo

Conditions:

speedup1
speedup2
potionspeed1
terrified
speedup3
potionspeed2
speedup4
potionspeed3
speeddown1
speeddown2
speeddown3
speeddown4
chilled
sapped
stalled
chill
freeze
stun
butter
bleeding
lightning
rush
tossed
warpingIn
potiontoughness1
potiontoughness2
potiontoughness3
hypnotized
sunbeaned
morphedtogargantuar
damageflash
zombossstun
haunted
icecubed
unsuspendable
invincible
warpingOut
poisoned
contagiouspoison
bloomingheartdebuff
squidified

Stages:

Tutorial - TutorialStage
Pinata Party - FrontLawnStage
Heroes Event Stage (DOESN'T WORK) - HeroesStage
Ancient Egypt - EgyptStage
Ancient Egypt (No Powerups) - EgyptStageNoPowerUps
Pirate Seas - PirateStage
Wild West - WestStage
Far Future - FutureStage
Dark Ages - DarkStage
Big Wave Beach - BeachStage
Big Wave Beach (No Powerups) - BeachStageNoPowerUps
Frostbite Caves - IceageStage
Frostbite Caves (No Powerups) - IceageStageNoPowerUps
Lost City - LostCityStage
Lost City (No Powerups) - LostCityStageNoPowerUps
Lost City Night (DOESN'T WORK) - LostCityNightsStage
Neon Mixtape Tour - EightiesStage
Jurassic Marsh - DinoStage
Modern Day - ModernStage
Modern Day (No Powerups) - ModernStageNoPowerUps
Battlez - JoustStage

Lawn Mowers:

Pinata Party - FrontLawnMowers
Ancient Egypt - EgyptMowers
Pirate Seas - PirateMowers
Wild West - WestMowers
Far Future - FutureMowers
Dark Ages - DarkMowers
Dark Ages (Battlez) - JoustDarkMowers
Big Wave Beach - BeachMowers
Frostbite Caves - IceageMowers
Lost City - LostCityMowers
Neon Mixtape Tour - EightiesMowers
Neon Mixtape Tour (Zomboss Fight) - EightiesZombossMowers
Jurassic Marsh - DinoMowers
Modern Day - ModernMowers

Grid Items:

Modern Gravestone - gravestone_tutorial
Egypt Gravestone - gravestone_egypt
Pirate Gravestone - gravestone_pirate
Cowboy Gravestone - gravestone_cowboy
Future Gravestone - gravestone_future
Dark Gravestone - gravestone_dark
Dark Gravestone (Sun) - gravestoneSunOnDestruction
Dark Gravestone (Plant Food) - gravestonePlantfoodOnDestruction
Battlez Gravestone - gravestone_battlez
Minecart (Modern) - railcart_tutorial
Minecart (Cowboy) - railcart_cowboy
Plank - plank
Infi-nut Shield - holoshield
Moonflower Shield - moonflowershield
Shield Zombie Shield - protectorshield
Shield Zombie Shield (Segment) - protectorshieldsegment
Gold Tile - goldtile
Power Tile (Alpha) - powertile_alpha
Power Tile (Beta) - powertile_beta
Power Tile (Gamma) - powertile_gamma
Power Tile (Delta) - powertile_delta
Power Tile (Epsilon) - powertike_epsilon
Potion (Speed) - zombiepotion_speed
Potion (Toughness) - zombiepotion_toughness
Lily Pad - lilypad
Vase - vase
Eggbreaker Vase - vase_egg
Firebreaker Vase - vase_firework
Surfboard - surfboard
Tent - tent
Imp Porter's Backpack - backpack
Octopus - planttarget_squid
Ice Block (Plant) - planttarget_iceblock
Ice Block (Zombie) - zombietarget_iceblock
Birthday Present - zombietarget_birthday_present
Frostbite Caves Slider (Up) - slider_up
Frostbite Caves Slider (Down) - slider_down
Modern Day Slider (Up) - slider_up_modern
Modern Day Slider (Down) - slider_down_modern
Sap-fling's Sap - sap
Sap-fling's Sap (Plant Food) - plantfoodsap
Lava Guava Lava Tile - lava
Jack O' Lantern Wisp - wisp
Zombot Tuskmaster 10,000 BC's Ice Blocks - zomboss_iceage_glacier_block
Boulder Trap - boulder_trap_falling_forward
Boulder Trap (Zomboss) - zomboss_boulder_trap_falling_forward
Fire Trap - flame_spreader_trap
Beghouled Crater - crater
Timed Crater - crater_timed
Speaker - speaker
Speaker (Zomboss) - speaker_zomboss
Arcade Cabinet - eightiesarcadecabinet
Dusk Lobber's Plant Food Flower - dusklobberflower
Bombegranate's Seeds - bombegranateseeds
Neon Mixtape Tour Portal - zombieportal_eighties
Jurassic Marsh Portal - zombieportal_dino
Lost City Portal - zombieportal_lostcity
Frostbite Caves Portal - zombieportal_iceage
Big Wave Beach Portal - zombieportal_beach
Dark Ages Portal - zombieportal_dark
Far Future Portal - zombieportal_future
Far Future Portal (Time Twister) - zombieportal_future_2
Wild West Portal - zombieportal_west
Pirate Seas Portal - zombieportal_pirate
Ancient Egypt Portal - zombieportal_egypt
Other Ancient Egypt Portal - zombieportal_egypt_2
Ancient Egypt Portal (Endless) - zombieportal_dangerroom_egypt
Pirate Seas Portal (Endless) - zombieportal_dangerroom_pirate
Wild West Portal (Endless) - zombieportal_dangerroom_west
Far Future Portal (Endless) - zombieportal_dangerroom_future
Dark Ages Portal (Endless) - zombieportal_dangerroom_dark
Big Wave Beach Portal (Endless) - zombieportal_dangerroom_beach
Frostbite Caves Portal (Endless) - zombieportal_dangerroom_iceage
Lost City Portal (Endless) - zombieportal_dangerroom_lostcity
Neon Mixtape Tour Portal (Endless) - zombieportal_dangerroom_eighties
Jurassic Marsh Portal (Endless) - zombieportal_dangerroom_dino
Poison Tile (Poison Peashooter) - poison_tile
Score 2x Tile - score_2x_tile
Score 3x Tile - score_3x_tile
Score 5x Tile - score_5x_tile

#COMMENT: The following grid items do not work or are really buggy.

Unused:

Zombie Gravestone - gravestoneZombieOnDestruction
Time Spawner Gravestone - gravestoneZombieTimeSpawner
Time Spawner Gravestone (Conehead) - gravestoneZombieTimeSpawner_cone
Time Spawner Gravestone (Buckethead) - gravestoneZombieTimeSpawner_bucket
Shortcut Gravestone - gravestoneShortcut
Beach Gravestone - gravestone_beach
Jurassic Gravestone - gravestone_dino
Frostbite Gravestone - gravestone_iceage
Neon Gravestone - gravestone_eighties
Lost Gravestone - gravestone_lostcity
Egypt Minecart - railcart_egypt
Pirate Minecart - railcart_pirate
Future Minecart - railcart_future
??? (DO NOT USE) - futureshift
??? (DO NOT USE) - futureclone
Whack-a-Zombie Puddle - whack_puddle

Music Types:

Ultimate Battle - MiniGame_A
Demonstration Minigame - MiniGame_B